NO ./path                         
SO ./path
EA ./path
WE ./path



F 200,100,0
C 225,30,0

11111111
10110101
1110N011
11111111