NO ./path

EA ./path

F ./path
C ./path
     WE ./path

						SO ./path

11111111
11110101
11101111
11111111