NO ./path                         
SO ./path
EA ./path
WE ./path



F 200,100,0
C 225,30,0

11111111
11110101
11101N11
11111111