NO ./texture/wall.xpm
SO ./texture/dofus.xpm
EA ./texture/dofup.xpm
WE ./texture/grass.xpm

F 200,100,0
C 225,30,0

1111111111
1000000001
10S0000001
1000101111
1111101111
1111101111
1000101111
1000000001
1000000011
1111111111
