NO ./path
SO ./path
EA ./path
WE ./path

F 20 0,100,0
C 225,30,0
F

11111111
11110101
11101111
11111111