NO ./texture/Face.xpm
SO ./texture/dofus.xpm
EA ./texture/dofup.xpm
WE ./texture/grass.xpm

F 200,100,0
C 225,30,0

11111
10001
1N001
1001
11111