NO ./texture/Face.xpm
SO ./texture/dofus.xpm
EA ./texture/dofup.xpm
WE ./texture/grass.xpm

F 200,100,0
C 225,30,0

 1111111 
111011111
100000001
100000001
100000001
100N00001
100000001
100000001
100000001
100000001
100000001
 1111111 