NO ./texture/Face.xpm
SO ./texture/dofus.xpm
EA ./texture/dofup.xpm
WE ./texture/grass.xpm

F 200,100,0
C 225,30,0

11111111111
10000000001
1N000000001
10000000011
10000000001
10000100011
10000000011
10000000001
11101111101
11100000001
111111111111