NO ./texture/Face.xpm
SO ./texture/dofus.xpm
EA ./texture/dofup.xpm
WE ./texture/grass.xpm

F 200,100,0
C 225,30,0
111111111
111011111
100000001
100000001
100000001
100000001
100000001
100000001
100000001
10N000001
100000001
111111111