NO ./texture/square-1000.xpm
EA ./texture/purple.xpm
SO ./texture/green.xpm
WE ./texture/Starfield.xpm

F 200,100,0
 C 5, 30,0

11111111111111111111111111111111111111111111
10000000000000000100000000000000000000001111
100000001000100000000000000001000000000000111111111111111111
1000000000010000000000000000001000000000000000000000000000001
100000000000000000000000000000000000N00000000000000000000001
1111101111111111111111111111111111111111011111111111111111111
1111101111                              1
10001011111111111
10000000000000001
1000000000000000111111
11111111111111011
1111111111111101
1111111111111111
