NO ./texture/blue.xpm
SO ./texture/green.xpm
EA ./texture/purple.xpm
WE ./texture/Starfield.xpm

F 200,100,0
C 5,30,0

1111111111
1000000001
10N0000001
1000100001
1111101111
1111101111
1000101111
1000000001
1000111111
1111
