NO


1111111 1
1111111

111111  1
1111111 